start,end,type,measure,start_beat,duration,track,TS,measure_score
0,8,a,1,0,8,1,4/4,1
8,11,b,3,0,3,0,4/4,3
12,15,c,4,0,3,0,4/4,4
16,24,a,5,0,8,0,4/4,5
24,27,b,7,0,3,0,4/4,7
28,31,c,8,0,3,0,4/4,8
32,37,c,9,0,5,0,4/4,9
41,45,b,11,1,4,1,4/4,11
44,52,d,12,0,8,0,4/4,12
52,60,a,14,0,8,0,4/4,14
60,63,b,16,0,3,0,4/4,16
64,67,c,17,0,3,0,4/4,17
68,76,a,18,0,8,0,4/4,18
76,79,b,20,0,3,0,4/4,20
80,83,c,21,0,3,0,4/4,21
84,87,c,22,0,3,0,4/4,22
88,91,c,23,0,3,0,4/4,23
120,123,e,31,0,3,1,4/4,31
122,125,e,31,2,3,0,4/4,31
124,127,e,32,0,3,1,4/4,32
126,130,e,32,2,4,0,4/4,32
130,136,e,33,2,6,0,4/4,33
136,144,f,35,0,8,0,4/4,35
144,152,f,37,0,8,0,4/4,37
152,160,f,39,0,8,0,4/4,39
160,165,f,41,0,5,0,4/4,41
168,176,f,43,0,8,0,4/4,43
176,183,f,45,0,7,0,4/4,45
183,192,f,46,3,9,0,4/4,46
196,204,i,50,0,8,0,4/4,50
204,212,i,52,0,8,0,4/4,52
260,264,e,66,0,4,0,4/4,66
264,268,e,67,0,4,0,4/4,67
268,272,e,68,0,4,0,4/4,68
272,276,e,69,0,4,0,4/4,69
276,280,e,70,0,4,0,4/4,70
280,284,e,71,0,4,0,4/4,71
292,297,c,74,0,5,0,4/4,74
302,311,h,76,2,9,0,4/4,76
308,313,c,78,0,5,1,4/4,78
318,325,h,80,2,7,0,4/4,80
325,333,h,82,1,8,0,4/4,82
333,341,h,84,1,8,0,4/4,84
340,348,a,86,0,8,1,4/4,1
348,351,b,88,0,3,0,4/4,3
352,355,c,89,0,3,0,4/4,4
356,364,a,90,0,8,0,4/4,5
364,367,b,92,0,3,0,4/4,7
368,371,c,93,0,3,0,4/4,8
372,377,c,94,0,5,0,4/4,9
381,385,b,96,1,4,1,4/4,11
384,392,d,97,0,8,0,4/4,12
392,400,a,99,0,8,0,4/4,14
400,403,b,101,0,3,0,4/4,16
404,407,c,102,0,3,0,4/4,17
408,416,a,103,0,8,0,4/4,18
416,419,b,105,0,3,0,4/4,20
420,423,c,106,0,3,0,4/4,21
424,427,c,107,0,3,0,4/4,22
428,431,c,108,0,3,0,4/4,23
460,463,e,116,0,3,1,4/4,31
462,465,e,116,2,3,0,4/4,31
464,467,e,117,0,3,1,4/4,32
466,470,e,117,2,4,0,4/4,32
470,476,e,118,2,6,0,4/4,33
476,484,f,120,0,8,0,4/4,35
484,492,f,122,0,8,0,4/4,37
492,500,f,124,0,8,0,4/4,39
500,505,f,126,0,5,0,4/4,41
508,516,f,128,0,8,0,4/4,43
516,523,f,130,0,7,0,4/4,45
523,532,f,131,3,9,0,4/4,46
536,544,i,135,0,8,0,4/4,50
544,552,i,137,0,8,0,4/4,52
600,604,e,151,0,4,0,4/4,66
604,608,e,152,0,4,0,4/4,67
608,612,e,153,0,4,0,4/4,68
612,616,e,154,0,4,0,4/4,69
616,620,e,155,0,4,0,4/4,70
620,624,e,156,0,4,0,4/4,71
632,637,c,159,0,5,0,4/4,74
642,651,h,161,2,9,0,4/4,76
648,653,c,163,0,5,1,4/4,78
658,665,h,165,2,7,0,4/4,80
665,673,h,167,1,8,0,4/4,82
673,681,h,169,1,8,0,4/4,84
681,689,h,171,1,8,0,4/4,86
689,697,h,173,1,8,0,4/4,88
696,704,a,175,0,8,1,4/4,90
704,707,b,177,0,3,0,4/4,92
708,711,c,178,0,3,0,4/4,93
712,715,b,179,0,3,0,4/4,94
716,719,c,180,0,3,0,4/4,95
720,722,b,181,0,2,0,4/4,96
722,724,c,181,2,2,0,4/4,96
724,726,b,182,0,2,0,4/4,97
726,728,c,182,2,2,0,4/4,97
728,730,b,183,0,2,0,4/4,98
730,732,c,183,2,2,0,4/4,98
732,734,b,184,0,2,0,4/4,99
734,736,c,184,2,2,0,4/4,99
736,738,b,185,0,2,0,4/4,100
738,740,c,185,2,2,0,4/4,100
740,742,b,186,0,2,0,4/4,101
742,744,c,186,2,2,0,4/4,101
744,746,b,187,0,2,0,4/4,102
746,748,c,187,2,2,0,4/4,102
748,750,c,188,0,2,0,4/4,103
750,752,c,188,2,2,0,4/4,103
752,754,b,189,0,2,0,4/4,104
754,756,b,189,2,2,0,4/4,104
756,760,b,190,0,4,0,4/4,105
760,762,b,191,0,2,0,4/4,106
762,764,b,191,2,2,0,4/4,106
764,768,b,192,0,4,0,4/4,107
768,770,b,193,0,2,0,4/4,108
770,772,b,193,2,2,0,4/4,108
772,776,b,194,0,4,0,4/4,109
776,780,b,195,0,4,0,4/4,110
780,784,b,196,0,4,0,4/4,111
784,788,i,197,0,4,0,4/4,112
800,804,i,201,0,4,0,4/4,116
816,820,i,205,0,4,0,4/4,120
921,923,c,231,1,2,0,4/4,146
923,925,c,231,3,2,0,4/4,146
925,929,c,232,1,4,0,4/4,147
929,931,c,233,1,2,0,4/4,148
931,933,c,233,3,2,0,4/4,148
933,937,c,234,1,4,0,4/4,149
937,939,c,235,1,2,0,4/4,150
939,941,c,235,3,2,0,4/4,150
941,945,c,236,1,4,0,4/4,151
945,947,c,237,1,2,0,4/4,152
947,952,c,237,3,5,0,4/4,152
960,968,a,241,0,8,0,4/4,156
968,971,b,243,0,3,0,4/4,158
972,975,c,244,0,3,0,4/4,159
976,984,a,245,0,8,0,4/4,160
984,987,b,247,0,3,0,4/4,162
988,991,c,248,0,3,0,4/4,163
992,997,c,249,0,5,0,4/4,164
1004,1012,d,252,0,8,0,4/4,167
1012,1020,d,254,0,8,0,4/4,169
1020,1033,d,256,0,13,0,4/4,171
1032,1040,a,259,0,8,1,4/4,174
1040,1043,b,261,0,3,0,4/4,176
1044,1047,c,262,0,3,0,4/4,177
1048,1056,a,263,0,8,0,4/4,178
1056,1059,b,265,0,3,0,4/4,180
1060,1063,c,266,0,3,0,4/4,181
1064,1067,c,267,0,3,0,4/4,182
1068,1072,c,268,0,4,0,4/4,183
1072,1076,c,269,0,4,0,4/4,184
1104,1107,e,277,0,3,1,4/4,192
1106,1109,e,277,2,3,0,4/4,192
1108,1111,e,278,0,3,1,4/4,193
1110,1114,e,278,2,4,0,4/4,193
1114,1120,e,279,2,6,0,4/4,194
1120,1128,f,281,0,8,0,4/4,196
1128,1136,f,283,0,8,0,4/4,198
1136,1148,f,285,0,12,0,4/4,200
1152,1160,f,289,0,8,0,4/4,204
1160,1167,f,291,0,7,0,4/4,206
1167,1176,f,292,3,9,0,4/4,207
1180,1188,i,296,0,8,0,4/4,211
1188,1196,i,298,0,8,0,4/4,213
1244,1248,e,312,0,4,0,4/4,227
1248,1252,e,313,0,4,0,4/4,228
1276,1281,c,320,0,5,0,4/4,235
1286,1292,h,322,2,6,0,4/4,237
1292,1297,c,324,0,5,0,4/4,239
1302,1309,h,326,2,7,0,4/4,241
1309,1317,h,328,1,8,0,4/4,243
1317,1325,h,330,1,8,0,4/4,245
1325,1333,h,332,1,8,0,4/4,247
1332,1340,a,334,0,8,1,4/4,249
1340,1343,b,336,0,3,0,4/4,251
1344,1347,c,337,0,3,0,4/4,252
1348,1351,b,338,0,3,0,4/4,253
1352,1356,c,339,0,4,0,4/4,254
1356,1358,b,340,0,2,0,4/4,255
1358,1360,c,340,2,2,0,4/4,255
1360,1362,b,341,0,2,0,4/4,256
1362,1364,c,341,2,2,0,4/4,256
1364,1366,c,342,0,2,0,4/4,257
1366,1368,c,342,2,2,0,4/4,257
1368,1373,c,343,0,5,0,4/4,258
1372,1380,a,344,0,8,1,4/4,259
1380,1388,a,346,0,8,0,4/4,261
1388,1391,b,348,0,3,0,4/4,263
1392,1395,c,349,0,3,0,4/4,264
1396,1404,a,350,0,8,0,4/4,265
1404,1407,b,352,0,3,0,4/4,267
1408,1411,c,353,0,3,0,4/4,268
1412,1415,b,354,0,3,0,4/4,269
1416,1419,c,355,0,3,0,4/4,270
1420,1423,c,356,0,3,0,4/4,271
1424,1426,c,357,0,2,0,4/4,272
1426,1428,c,357,2,2,0,4/4,272
1428,1430,c,358,0,2,0,4/4,273
1430,1432,c,358,2,2,0,4/4,273
1432,1434,c,359,0,2,0,4/4,274
1434,1436,c,359,2,2,0,4/4,274
1436,1437,b,360,0,1,0,4/4,275
1437,1438,b,360,1,1,0,4/4,275
1438,1439,b,360,2,1,0,4/4,275
1439,1440,b,360,3,1,0,4/4,275
1445,1449,c,362,1,4,0,4/4,277
1472,1480,f,369,0,8,0,4/4,284
1480,1488,f,371,0,8,0,4/4,286
1488,1500,f,373,0,12,0,4/4,288
1500,1508,f,376,0,8,0,4/4,291
1508,1517,f,378,0,9,1,4/4,293
1516,1524,a,380,0,8,0,4/4,295
1524,1526,b,382,0,2,0,4/4,297
1526,1528,b,382,2,2,0,4/4,297
1528,1530,b,383,0,2,0,4/4,298
1530,1537,c,383,2,7,0,4/4,298
1540,1545,d,386,0,5,0,4/4,301
